FFFFFFFFFFFFFFFFFFFFFFFFF
FXXXXXXXXXXXXXFFFFFXXXXXF
FXXXXXXXXXXXXXFFFFFXXXXXF
FXXSFFFFFFFFFFFFFFFXXXXXF
FXXXXXXFFFFFFFFFFFFXXXXXF
FFFFFFFFFFFFFFFXXXXXXFFFF
FXXXXXFFFFFFFFFFFFFFFXXXF
FXXXXXXXXXXXXXFFFFFFFXXXF
FXXXXXXXXXXXXXFFFFFFFXXXF
FXXXXXXFFFFFFFFFFFFFFXXXF
FXXXXXXFFFFFFFFFFFFFFXXXF
FXXXXXXXXXEFFFFFXXXXXXXXF
FFFFFFFFFFFFFFFFFFFFFFFFF
FFFFFFFFFFFFFFFFFFFFFFFFF
FFFFFFFFFFFFFFFFFFFFFFFFF